# https://www.data.go.kr/data/15013205/standard.do

역사명	한자역사명
부평삼거리	富平三거리
간석오거리	間石五거리
인천시청	仁川市廳
예술회관	藝術會館
인천터미널	仁川터미널
문학경기장	文鶴競技場
선학	仙鶴
신연수	新延壽
원인재	源仁齋
동춘	東春
동막	東幕
캠퍼스타운	-
테크노파크	-
임학	林鶴
계산	桂山
경인교대입구	京仁敎大入口
작전	鵲田
갈산	葛山
부평구청	富平區廳
부평시장	富平市場
부평	富平
동수	東樹
장산역	山
동대문역사문화공원	東大門歷史文化公園
신당	新堂
상왕십리	上往十里
왕십리	往十里
한양대	漢陽大
뚝섬	纛島
성수	聖水
건대입구	建大入口
구의	九宜
강변	江邊
잠실나루	蠶室渡口
잠실	蠶室
정평	正坪
임당	林堂
영남대	嶺南大
칠곡경대병원	漆谷 慶大病院
학 정	鶴亭
팔 거	八거
동 천	東川
칠곡운암	漆谷雲岩
구 암	鳩岩
태 전	太田
매 천	梅川
매천시장	梅川市場
팔 달	八達
공 단	工團
만 평	萬坪
팔달시장	八達市場
안평역	安平
고촌역	古村
동부산대학역	東釜山大學
영산대역	靈山大
석대역	石坮
반여농산물시장역	盤如農産物市場
금사역	錦絲
서동역	書洞
명장역	鳴藏
충렬사역	忠烈祠
낙민역	樂民
수안역	壽安
동래역(4호선)	東萊
미남역(4호선)	美南
대저역	大渚
체육공원역	體育公園
강서구청역	江西區廳
구포역	龜浦
덕천역(3호선)	德川
숙등역	淑嶝
남산정역	南山亭
만덕역	萬德
미남역(3호선)	美南
사직역	社稷
종합운동장역	綜合運動場
거제역	巨堤
연산역(3호선)	蓮山
물만골역	水滿谷
배산역	盃山
망미역	望美
수영역(3호선)	水營
양산역	梁山
남양산역	南梁山
부산대양산캠퍼스역	釜山大梁山Campus
증산역	甑山
호포역	湖浦
금곡역	金谷
동원역	東院
율리역	栗里
화명역	華明
수정역	水亭
덕천역(2호선)	德川
구명역	龜明
구남역	龜南
모라역	毛羅
모덕역	毛德
덕포역	德浦
사상역	沙上
감전역	甘田
주례역	周禮
냉정역	冷井
개금역	開琴
동의대역	東義大
가야역	伽倻
부암역	釜岩
서면역(2호선)	西面
전포역	田浦
국제금융센터부산은행역	釜山國際金融中心·釜山銀行
문현역	門峴
지게골역	支架谷
못골역	池谷
대연역	大淵
경성대부경대역	慶星大釜慶大
남천역	南川
금련산역	金蓮山
광안역	廣安
수영역	水營
민락역	民樂
센텀시티역	Centum City
시립미술관역	市立美術館
동백역	冬柏
해운대역	海雲臺
중동역	中洞
장산역	山
노포역	老圃
범어사역	梵魚寺
남산역	南山
두실역	斗實
구서역	久瑞
장전역	長箭
부산대역	釜山大學校
온천장역	溫泉場
명륜역	明倫
동래역	東萊
교대역	釜山敎育大學校
연산역	蓮山
시청역	市廳
양정역	楊亭
부전역	釜田
서면역(1호선)	西 面
범내골역	凡內谷
범일역	凡一
좌천역	佐川
부산진역	釜山鎭
초량역	草梁
원 대	院垈
북구청	北區廳
달성공원	達城公園
서문시장	西門市場
청라언덕	靑蘿坡
남 산	南山
명 덕	明德
건들바위	없음
대봉교	大鳳橋
수성시장	壽城市場
수성구민운동장	壽城區民運動場
어린이회관	없음
황 금	黃金
수성못	없음
지 산	池山
범 물	凡勿
용 지	龍池
부산역	釜山驛
중앙역	中央
남포역	南浦
자갈치역	札其
토성역	土城
동대신역	東大新
서대신역	西大新
대티역	大峙
괴정역	槐亭
사하역	沙下
당리역	堂里
하단역	下端
녹동역	鹿洞
소태역	所台
학동증심사입구역	鶴洞ㆍ證心寺入口
남광주역	南光州
문화전당역(구도청)	文化殿堂
금남로4가역	錦南路4街
금남로5가역	錦南路5街
양동시장역	良洞市場
돌고개역	해당사항 없음
농성역	農城
화정역	花亭
쌍촌역	雙村
운천역	云泉
상무역	尙武
김대중컨벤션센터(마륵)역	馬勒
신평역	新平
동매역	東 山
장림역	長林
신장림역	新長林
낫개역	羅 浦
다대포항역	多大浦港
다대포해수욕장	多大浦海水浴場
서울역	首爾站
시청	市廳
종각	鐘閣
종로3가	鍾路三街
종로5가	鐘路五街
공항역	空港
송정공원역	松汀公園
광주송정역	光州松汀站
도산역	道山
평동역	平洞
발곡	鉢谷
회룡	回龍
범골	
경전철의정부	輕電鐵議政府
의정부시청	議政府市廳
흥선	興宣
의정부중앙	議政府中央
동오	東梧
새말	
경기도청북부청사	京畿道廳北部廳舍
효자	孝子
곤제	昆弟
어룡	魚龍
송산	松山
부산원동역	釜山院洞
임진강역	臨津江
서울역(경의선)	
신촌역	新 村
가좌역	加 佐
효창공원앞역	孝昌公圓앞
공덕역	孔德
서강대역	西江大
홍대입구역	弘大入口
디지털미디어시티역	디지털미디어시티
수색역	水 色
화전역	花 田
강매역	江 梅
행신역	幸 信
능곡역	陵 谷
곡산역	谷 山
백마역	白 馬
풍산역	楓山
일산역	一 山
탄현역	炭 峴
야당역	野?
왕십리역	往十里
청량리역	淸凉里
회기역	回 基
외대앞역	外大앞
신이문역	新里門
석계역	石 溪
광운대역	城 北
월계역	月 溪
녹천역	鹿 川
창동역	倉 洞
방학역	放 鶴
도봉역	道 峰
도봉산역	道峰山
망월사역	望月寺
회룡역	回 龍
의정부역	議政府
가능역	佳 陵
녹양역	綠 楊
양주역	楊 州
덕계역	德 溪
덕정역	德 亭
지행역	紙 杏
동두천중앙역	東豆川中央
보산역	保 山
동두천역	東豆川
소요산역	逍遙山
중랑역	中 浪
상봉역	
망우역	忘 憂
양원역	養 源
지평역	
구리역	九 里
도농역	陶 農
양정역	養 正
덕소역	德 沼
도심역	陶 深
팔당역	八 堂
운길산역	蕓吉山
양수역	兩 水
신원역	新 院
국수역	菊 秀
아신역	我 新
오빈역	梧濱
양평역	楊 平
원덕역	元 德
용문역	龍 門
서울숲역	
압구정로데오역	
강남구청역	江南區廳
선정릉역	
선릉역	宣 陵
한티역	-
도곡역	道 谷
구룡역	九 龍
개포동역	開 浦 洞
대모산입구역	大 母 山入 口
수서역	水 西
복정역	福 井
가천대역	
태평역	太 平
모란역	牡 丹
야탑역	野 塔
이매역	二 梅
서현역	書 峴
수내역	藪 內
정자역	亭 子
미금역	美 金
오리역	梧 里
죽전역	竹 田
보정역	寶 亭
구성역	駒 城
신갈역	新 葛
기흥역	器 興
상갈역	上 葛
청명역	淸 明
영통역	靈 通
망포역	網 浦
매탄권선역	梅灘勸善
수원시청역	水原市廳
매교역	梅橋
신내역	新 內
갈매역	葛 梅
별내역	別 內
퇴계원역	退溪院
사릉역	思 陵
금곡역	金 谷
평내호평역	坪內好坪
천마산역	天摩山
마석역	磨 石
대성리역	大成里
청평역	淸 平
상천역	上 泉
가평역	加 平
굴봉산역	屈峰山
백양리역	白楊里
강촌역	江 村
김유정역	金裕貞
남춘천역	南春川
춘천역	春 川
판교역	板橋
삼동역	三洞
경기광주역	京畿廣州
초월역	草月
곤지암역	昆池岩
신둔도예촌역	新屯陶藝村
수원역	水 原
세류역	細 柳
병점역	餠 店
서동탄역	西東灘
세마역	洗 馬
오산대역	烏山大
오산역	烏 山
진위역	振 威
송탄역	松 炭
지제역	芝 制
서정리역	西井里
평택역	平 澤
구일역	九 一
개봉역	開 峯
오류동역	梧柳洞
온수역	溫 水
역곡역	驛 谷
소사역	素 砂
부천역	富 川
중동역	中 洞
송내역	松 內
부개역	富 開
부평역	富 平
백운역	白 雲
동암역	銅 岩
간석역	間 石
주안역	朱 安
도화역	道 禾
명학역	鳴 鶴
제물포역	濟物浦
도원역	桃 源
동인천역	東仁川
인천역	仁 川
선바위역	
경마공원역	競 馬公 園
대공원역	大公園
과천역	果 川
정부과천청사역	政府果川廳舍
이천역	利川
박촌	朴村
부발역	夫鉢
세종대왕릉역	世宗大王陵
여주역	驪州
성환역	成 歡
직산역	稷 山
두정역	斗 井
천안역	天 安
봉명역	鳳鳴
쌍용(나사렛대)역	雙龍(拿撒勒大)
아산역	牙 山
배방역	排 芳
온양온천역	溫陽溫泉
신창(순천향대)역	신 창
부전역	釜 田
거제해맞이역	巨堤해맞이
거제역	巨 堤
교대역	敎 大
동래역	東 萊
안락역	安 樂
재송역	裁 松
센텀역	-
벡스코역	-
신해운대역	新海雲臺
송정역	松 亭
오시리아역	-
기장역	機 張
일광역	日 光
광명역	光 明
석수역	石 水
관악역	冠 岳
안양역	安 養
운정역	雲 井
금릉역	金 陵
금촌역	金 村
귤현	橘峴
월롱역	月 籠
파주역	坡 州
문산역	汶 山
남영역	南 營
용산역	龍 山
지축역	紙 杻
안산역	安 山
삼송역	三 松
원흥역	元興
원당역	元 堂
화정역	花 井
대곡역	大 谷
백석역	白 石
마두역	馬 頭
정발산역	鼎鉢山
주엽역	注 葉
대화역	大 化
이촌역	二 村
서빙고역	西氷庫
한남역	漢 南
노량진역	鷺梁津
대방역	大 方
신길역	新 吉
영등포역	永登浦
신도림역	新道林
구로역	九 老
가산디지털단지역	加山디지털團 地
독산역	禿 山
금천구청역	衿川區廳
금정역	衿 井
군포역	軍 浦
당정역	當井
의왕역	義 王
성균관대역	成 均 館 大
화서역	華 西
수원(분당)역	水 原
인덕원역	仁德院
평촌역	坪 村
범계역	凡溪
산본역	山 本
수리산역	修理山
대야미역	大夜味
반월역	半 月
상록수역	常綠樹
중앙역	中 央
한대앞역	漢大앞
고잔역	古 棧
초지역	草 芝
신길온천역	新 吉溫 泉
정왕역	正 往
오이도역	烏耳島
고색	古索
오목천	梧木川
어천	漁川
야목	野牧
사리	四理
한대앞	漢大앞
중앙	中央
고잔	古棧
초지	草芝
안산	安山
신길온천	新吉溫泉
정왕	正往(韓國産業技術大)
오이도	烏耳島
달월역	達月
월곶역	月串
소래포구역	蘇來浦口
인천논현역	仁川論峴
계양	桂陽
호구포역	虎口浦
남동인더스파크역	
원인재역	源仁齋
연수역	延壽
송도역	松島
인하대역	仁荷大
숭의역	崇 義
신포역	新 浦
옥수역	玉 水
응봉역	鷹 峰
인천	仁川
각산	角山
안심	安心
문양	汶陽
다사	多斯
대실	없음
강창	江倉
계명대	啓明大
성서산업단지	城西工團
이곡	梨谷
용산	龍山
죽전	竹田
감삼	甘三
두류	頭流
내당	內唐
반고개	없음
청라언덕	靑蘿坡
반월당	半月堂
경대병원	慶大病院
대구은행	大邱銀行
범어	泛魚
수성구청	壽城區廳
만촌	晩村
담티	(壽城大.大倫)
연호	蓮湖
대공원	大公園
고산	孤山
신매	新梅
사월	沙月
탑석	塔石
지식정보단지	知識情報團地
인천대입구	仁川大入口
센트럴파크	-
국제업무지구	國際業務地區
검단오류	黔丹梧柳
왕길	旺吉
검단사거리	黔丹十字路口
마전	麻田
완정	完井
독정	篤 亭
검암	黔岩
검바위	黔石
아시아드경기장	亞運會賽場
서구청	西區廳
가정(루원시티)	佳亭
가정중앙시장	佳亭中央市場
석남(거북시장)	石南
영대병원	嶺大病院
교대	敎大
명덕	明德
반월당	半月堂
중앙로	中央路
대구	大邱驛
칠성시장	七星市場
양촌역	陽忖
구래역	九來
마산역	麻山
장기역	場基
운양역	雲陽
걸포북변역	傑浦北邊
사우(김포시청)역	沙隅(金浦市廳)
서부여성회관	西部女性會館
인천가좌	仁川佳佐
가재울	伽岾溪
주안국가산단	朱安國家産團
주안	朱安
시민공원	市民公園
석바위시장	石岩市場
인천시청	仁川市廳
석천사거리	石泉十字路口
모래내시장	沙丘市場
만수	万壽
남동구청	南洞區廳
인천대공원	仁川大公園
운연	云宴
발곡	鉢谷
회룡	回龍
범골	-
경전철의정부	輕電鐵議政府
의정부시청	議政府市廳
흥선	興宣
의정부중앙	議政府中央
동오	東梧
새말	-
경기도청북부청사	京畿道廳北部廳舍
효자	孝子
곤제	昆弟
어룡	魚龍
송산	松山
탑석	塔石
미사역	渼沙
하남풍산역	河南豊山
사상역	沙上
괘법르네시떼역	掛法
서부산유통지구역	西釜山 流通地區
공항역	控抗
덕두역	德斗
등구역	登龜
대저역	大猪
평강역	平江
대사역	大沙
불암역	佛岩
지내역	池內
김해대학역	金海大學
인제대역	仁濟大
김해시청역	金海市廳
부원역	府院
봉황역	鳳凰
수로왕릉역	首露王陵
박물관역	博物館
연지공원역	蓮池公園
장신대역	長神大
가야대역	加耶大
신천	新川
동대구	東大邱驛
동구청	東區廳
아양교	峨洋橋
동촌	東村
해안	解顔
방촌	芳村
용계	龍溪
율하	栗下
신기	新基
반야월	半夜月
설화명곡	舌化椧谷
화원	花園
대곡	大谷
진천	辰泉
월배	月背
상인	上仁
월촌	月村
송현	松峴
성당못	聖堂못
대명	大明
안지랑	없음
현충로	顯忠路
풍무역	豊舞
고촌역	高忖
김포공항역	金浦空港
판암	板岩
신흥	新興
대동	大洞
대전	大田
중앙로	中央路
중구청	中區廳
서대전네거리	西大田네거리
오룡	五龍
용문	龍汶
탄방	炭坊
시청	市廳
정부청사	政府廳舍
갈마	葛馬
월평	月坪
갑천	甲川
유성온천	儒城溫泉
구암	九岩
현충원	顯忠院
월드컵경기장	월드컵競技場
노은	老隱
지족	智足
반석	盤石
중동역	中洞
해운대역	海雲臺
동백역	冬柏
시립미술관역	市立美術館
센텀시티역	Centum City
민락역	民樂
수영역	水營
광안역	廣安
금련산역	金蓮山
남천역	南川
경성대부경대역	慶星大釜慶大
대연역	大淵
못골역	池谷
지게골역	支架谷
문현역	門峴
국제금융센터부산은행역	釜山國際金融中心·釜山銀行
전포역	田浦
서면역(2호선)	西面
부암역	釜岩
가야역	伽倻
동의대역	東義大
개금역	開琴
냉정역	冷井
주례역	周禮
감전역	甘田
사상역	沙上
덕포역	德浦
모덕역	毛德
모라역	毛羅
구남역	龜南
구명역	龜明
덕천역(2호선)	德川
수정역	水亭
화명역	華明
율리역	栗里
동원역	東院
금곡역	金谷
호포역	湖浦
증산역	甑山
부산대양산캠퍼스역	釜山大梁山Campus
남양산역	南梁山
양산역	梁山
기흥역	器興
강남대역	江南大
지석역	支石
어정역	御井
동백역	東栢
초당역	草堂
삼가역	三街
시청-용인대역	龍仁市廳·龍仁大
명지대역	明知大
김량장역	金良場
운동장-송담대역	運動場·松潭大
고진역	古陳
보평역	洑坪
둔전역	屯田
전대-에버랜드역	前垈·에버랜드
동대문	東大門
신설동	新設洞
제기동	祭基洞
청량리	淸凉里
동묘앞	東廟
까치산	喜鵲山
시청	市廳
을지로입구	乙支路入口
을지로3가	乙支路三街
을지로4가	乙支路四街
잠실새내	蠶室-驛
종합운동장	綜合運動場
삼성	三成
선릉	宣陵
역삼	驛三
강남	江南
교대	敎大
서초	瑞草
방배	方背
사당	舍堂
낙성대	落星垈
서울대입구	首爾大入口
봉천	奉天
신림	新林
신대방	新大方
구로디지털단지	九老數碼團地
대림	大林
신도림	新道林
문래	文來
영등포구청	永登浦區廳
당산	堂山
합정	合井
홍대입구	弘大入口
신촌	新村
이대	梨花女子大學
아현	阿峴
충정로	忠正路
용답	龍踏
신답	新踏
신설동	新設洞
도림천	道林川
양천구청	陽川區廳
신정네거리	新亭十字路口
용두	龍頭
지축	紙木丑
구파발	舊把撥
연신내	延臣川
불광	佛光
녹번	碌磻
홍제	弘濟
무악재	毋岳齋
독립문	獨立門
경복궁	景福宮
안국	安國
종로3가	鍾路3街
을지로3가	乙支路3街
충무로	忠武路
동대입구	東大入口
약수	藥水
금호	金湖
옥수	玉水
압구정	狎鷗亭
신사	新沙
잠원	蠶院
고속터미널	高速巴士客運
답십리	踏十里
교대	敎大
남부터미널	南部巴士客運
양재	良才
매봉	梅峰
도곡	道谷
대치	大峙
학여울	Hangnyeoul
대청	大廳
일원	逸院
수서	水西
가락시장	可樂市場
경찰병원	警察病院
오금	梧琴
당고개	堂嶺
상계	上溪
노원	蘆原
창동	倉洞
쌍문	雙門
수유	水逾
미아	彌阿
미아사거리	彌阿十字路口
길음	吉音
성신여대입구	誠信女大入口
한성대입구	漢城大入口
혜화	惠化
동대문	東大門
동대문역사문화공원	東大門歷史文化公園
충무로	忠武路
명동	明洞
회현	會賢
서울역	首爾站
숙대입구	淑大入口
삼각지	三角地
신용산	新龍山
이촌	二村
동작	銅雀
총신대입구	總神大入口
사당	舍堂
남태령	南泰嶺
방화	傍花
개화산	開花山
김포공항	金浦空港
송정	松亭
마곡	麻谷
발산	鉢山
우장산	雨裝山
화곡	禾谷
까치산	喜鵲山
신정	新亭
목동	木洞
오목교	梧木橋
양평	楊坪
영등포구청	永登浦區廳
영등포시장	永登浦市場
신길	新吉
여의도	汝矣島
여의나루	汝矣渡口
마포	麻浦
공덕	孔德
애오개	兒嶺
충정로	忠正路
서대문	西大門
광화문	光化門
종로3가	鍾路三街
을지로4가	乙支路四街
동대문역사문화공원	東大門歷史文化公園
청구	靑丘
신금호	新金湖
행당	杏堂
왕십리	往十里
마장	馬場
장한평	長漢坪
군자	君子
아차산	峨嵯山
광나루	廣渡口
천호	千戶
강동	江東
길동	吉洞
굽은다리	曲橋
명일	明逸
고덕	高德
상일동	上一洞
둔촌동	遁村洞
올림픽공원	Olympic Park
방이	芳荑
오금	梧琴
개롱	開籠
거여	巨余
마천	馬川
응암	鷹岩
역촌	驛村
불광	佛光
독바위	瓮岩
연신내	延臣川
구산	龜山
새절	Saejeol
증산	繒山
디지털미디어시티	數碼媒體城
월드컵경기장	世界杯競技場
마포구청	麻浦區廳
망원	望遠
합정	合井
상수	上水
광흥창	廣興倉
대흥	大興
공덕	孔德
효창공원앞	孝昌公園
삼각지	三角地
녹사평	綠莎坪
이태원	梨泰院
한강진	漢江鎭
버티고개	波堤通
약수	藥水
청구	靑丘
신당	新堂
동묘앞	東廟
창신	昌信
보문	普門
안암	安岩
고려대	高麗大
월곡	月谷
상월곡	上月谷
돌곶이	多爾谷齊
석계	石溪
태릉입구	泰陵
화랑대	花郞臺
봉화산	烽火山
신내	新內
장암	長岩
도봉산	道峰山
수락산	水落山
마들	馬得
노원	蘆原
중계	中溪
하계	下溪
공릉	孔陵
태릉입구	泰陵
먹골	墨谷
중화	中和
상봉	上鳳
면목	面牧
사가정	四佳亭
용마산	龍馬山
중곡	中谷
군자	君子
어린이대공원	兒童大公園
건대입구	建大入口
뚝섬유원지	
청담	淸潭
강남구청	江南區廳
학동	鶴洞
논현	論峴
반포	盤浦
고속터미널	高速巴士客運
내방	內方
이수	梨水
남성	南城
숭실대입구	崇實大入口
상도	上道
장승배기	長丞拜基
신대방삼거리	新大方丁字路口
보라매	波拉梅
신풍	新豊
대림	大林
남구로	南九老
가산디지털단지	加山數碼團地
철산	鐵山
광명사거리	光明十字路口
천왕	天旺
온수	溫水
까치울	鵲洞
부천종합운동장	富川綜合運動場
춘의	春衣
신중동	新中洞
부천시청	富川市廳
상동	上洞
삼산체육관	三山體育館
굴포천	掘浦川
부평구청	富平區廳
암사	岩寺
천호	千戶
강동구청	江東區廳
몽촌토성	夢村土城
잠실	蠶室
석촌	石村
송파	松坡
가락시장	可樂市場
문정	文井
장지	長旨
복정	福井
산성	山城
남한산성입구	南漢山城入口
단대오거리	Dandaeogeori
신흥	新興
수진	壽進
모란	牡丹
언주	彦州
선정릉	宣靖陵
삼성중앙	三成中央
봉은사	奉恩寺
종합운동장	綜合運動場
삼전	三 田
석촌고분	石村古墳
석촌	石村
송파나루	松坡나루
한성백제	漢城百?
올림픽공원	올림픽公園(韓國體大)
둔촌오륜	遁村五輪
중앙보훈병원	中央報?病院