家	傢
价	價
诃	訶
贾	賈
轲	軻
镓	鎵
驾	駕
却	卻
珏	玨
脚	腳
壳	殼
悫	愨
搁	擱
觉	覺
阁	閣
奸	姦
杆	桿
干	榦
干	幹
秆	稈
赶	趕
垦	墾
恳	懇
悭	慳
拣	揀
涧	澗
痫	癇
简	簡
羟	羥
艰	艱
谏	諫
间	間
龈	齦
减	減
尴	尷
监	鑑
监	監
硷	鹼
碱	堿
绀	紺
鉴	鑒
阚	闞
龛	龕
钾	鉀
闸	閘
强	彊
姜	薑
襁	繈
强	強
冈	岡
刚	剛
岗	崗
纲	綱
绛	絳
绦	絳
缰	韁
讲	講
钢	鋼
镪	鏹
盖	蓋
个	個
个	箇
凯	凱
剀	剴
垲	塏
开	開
忾	愾
恺	愷
钙	鈣
铠	鎧
锴	鍇
赓	賡
铿	鏗
据	據
举	舉
榉	櫸
讵	詎
钜	鉅
锯	鋸
干	乾
键	鍵
骞	騫
骞	鶱
杰	傑
俭	儉
剑	劍
捡	撿
检	檢
睑	瞼
脸	臉
钤	鈐
击	擊
缂	緙
缴	繳
觋	覡
阒	闃
坚	堅
牵	牽
笕	筧
纤	縴
绢	絹
缱	繾
茧	繭
见	見
谴	譴
鲣	鰹
鹃	鵑
决	決
洁	潔
结	結
诀	訣
阕	闋
缣	縑
谦	謙
钳	鉗
鹣	鶼
郏	郟
倾	傾
刭	剄
劲	勁
垧	坰
庆	慶
弪	弳
径	徑
惊	驚
氢	氫
泾	涇
烃	烴
琼	瓊
痉	痙
竞	競
经	經
绠	綆
胫	脛
茎	莖
茕	煢
轻	輕
迳	逕
镜	鏡
顷	頃
颈	頸
鲠	鯁
鲸	鯨
系	係
系	繫
启	啓
启	啟
届	屆
继	繼
蓟	薊
计	計
诫	誡
锲	鍥
阶	階
鸡	雞
鸡	鷄
考	攷
雇	僱
槁	薧
库	庫
蛊	蠱
裤	褲
诂	詁
诰	誥
钴	鈷
铐	銬
锆	鋯
锢	錮
顾	顧
鸪	鴣
谷	穀
喾	嚳
毂	轂
鹄	鵠
衮	袞
困	睏
滚	滾
绲	緄
辊	輥
锟	錕
阃	閫
鲧	鯀
鲲	鯤
鹘	鶻
杠	槓
巩	鞏
筇	笻
贡	貢
赣	贛
龚	龔
夸	誇
伙	夥
剐	剮
埚	堝
挝	撾
课	課
过	過
锅	鍋
锞	錁
颗	顆
骒	騍
椁	槨
毋	毌
关	關
宽	寬
惯	慣
掼	摜
绾	綰
观	觀
贯	貫
馆	館
髋	髖
鹳	鸛
刮	颳
鸹	鴰
匡	劻
广	廣
圹	壙
旷	曠
犷	獷
矿	礦
纩	纊
诓	誆
诳	誑
邝	鄺
挂	掛
拐	枴
呙	咼
诖	詿
坏	壞
块	塊
蒉	蕢
帼	幗
掴	摑
蝈	蟈
轰	轟
闳	閎
乔	喬
侨	僑
啮	嚙
娇	嬌
峤	嶠
挢	撟
搅	攪
桥	橋
矫	矯
硗	磽
绞	絞
翘	翹
胶	膠
荞	蕎
跷	蹺
轿	轎
较	較
铰	鉸
饺	餃
骄	驕
鲛	鮫
球	毬
扣	釦
苟	茍
伛	傴
区	區
厩	廄
呕	嘔
够	夠
妪	嫗
屦	屨
岖	嶇
巯	巰
惧	懼
抠	摳
旧	舊
构	構
构	搆
欧	歐
殴	毆
沟	溝
沤	漚
瓯	甌
窭	窶
缑	緱
觏	覯
讴	謳
购	購
赇	賕
躯	軀
钆	釓
钩	鉤
阄	鬮
飓	颶
驱	驅
驹	駒
鸠	鳩
鸥	鷗
鸲	鴝
龟	龜
曲	麯
局	跼
局	侷
局	挶
国	國
锔	鋦
军	軍
皲	皸
诎	詘
宫	宮
穷	窮
卷	捲
蜷	踡
劝	勸
权	權
绻	綣
锩	錈
颧	顴
阙	闕
鳜	鱖
匦	匭
匮	匱
愦	憒
柜	櫃
溃	潰
篑	簣
缋	繢
诡	詭
轨	軌
馈	饋
馈	餽
刿	劌
归	歸
贵	貴
妫	媯
岿	巋
窍	竅
窥	窺
纠	糾
规	規
闺	閨
匀	勻
钧	鈞
克	剋
剧	劇
极	極
枣	棘
卺	巹
筋	觔
仅	僅
觐	覲
谨	謹
馑	饉
锦	錦
汲	伋
级	級
给	給
恒	恆
几	幾
机	機
旗	旂
弃	棄
只	祇
只	衹
致	衹
叽	嘰
岂	豈
桤	榿
气	氣
玑	璣
矶	磯
纪	紀
绮	綺
羁	羈
蕲	蘄
虮	蟣
觊	覬
讥	譏
记	記
颀	頎
饥	飢
饥	饑
骐	騏
骑	騎
骥	驥
鳍	鰭
紧	緊
鲒	鮚
吃	喫
傩	儺
诺	諾
难	難
纳	納
钠	鈉
乃	迺
内	內
钕	釹
捻	撚
宁	寧
咛	嚀
拧	擰
柠	檸
泞	濘
聍	聹
祢	禰
驽	駑
侬	儂
农	農
哝	噥
浓	濃
脓	膿
恼	惱
脑	腦
馁	餒
袅	裊
袅	嬝
铙	鐃
呐	吶
讷	訥
纽	紐
钮	鈕
你	妳
腻	膩
铌	鈮
昵	暱
端	耑
单	單
团	團
团	糰
坛	壇
抟	摶
断	斷
瘅	癉
箪	簞
簖	籪
缎	緞
郸	鄲
钽	鉭
锻	鍛
哒	噠
挞	撻
獭	獺
达	達
钽	鐽
闼	闥
鞑	韃
担	擔
胆	膽
坛	罈
昙	曇
荨	蕁
谈	談
谭	譚
锬	錟
党	黨
傥	儻
当	當
当	儅
当	噹
戆	戇
挡	擋
档	檔
裆	襠
谠	讜
铛	鐺
镗	鏜
饧	餳
台	臺
台	檯
对	對
带	帶
怼	懟
贷	貸
镦	鐓
队	隊
涂	塗
图	圖
导	導
岛	島
捣	搗
捣	擣
涛	濤
焘	燾
盗	盜
祷	禱
绦	縚
赌	賭
镀	鍍
韬	韜
椟	櫝
渎	瀆
牍	牘
犊	犢
独	獨
秃	禿
笃	篤
读	讀
黩	黷
炖	燉
趸	躉
顿	頓
饨	飩
冬	鼕
东	東
冻	凍
动	動
岽	崠
栋	棟
铜	銅
鸫	鶇
斗	鬥
头	頭
窦	竇
钭	鈄
钝	鈍
藤	籐
灯	燈
腾	騰
誊	謄
邓	鄧
镫	鐙
懒	懶
椤	欏
猡	玀
癞	癩
箩	籮
罗	羅
罗	囉
罗	儸
脶	腡
萝	蘿
逻	邏
锣	鑼
镙	鏍
骡	騾
泺	濼
络	絡
荦	犖
铬	鉻
骆	駱
乱	亂
兰	蘭
拦	攔
斓	斕
栏	欄
栾	欒
滦	灤
澜	瀾
烂	爛
谰	讕
銮	鑾
镧	鑭
阑	闌
鸾	鸞
岚	嵐
揽	攬
榄	欖
滥	濫
篮	籃
缆	纜
蓝	藍
褴	襤
览	覽
蜡	蠟
腊	臘
琅	瑯
锒	鋃
阆	閬
崃	崍
徕	徠
来	來
涞	淶
睐	睞
莱	萊
铼	錸
梁	樑
凉	涼
粮	糧
两	兩
俩	倆
谅	諒
辆	輛
魉	魎
丽	麗
侣	侶
俪	儷
励	勵
厉	厲
吕	呂
庐	廬
榈	櫚
滤	濾
疠	癘
砺	礪
粝	糲
胪	臚
虑	慮
蛎	蠣
铝	鋁
闾	閭
驴	驢
骊	驪
鲡	鱺
历	歷
历	曆
呖	嚦
坜	壢
枥	櫪
栎	櫟
沥	瀝
砾	礫
苈	藶
跞	躒
轹	轢
郦	酈
镉	鎘
雳	靂
怜	憐
娈	孌
孪	孿
恋	戀
挛	攣
撵	攆
涟	漣
炼	煉
琏	璉
练	練
联	聯
脔	臠
莲	蓮
裢	褳
辇	輦
连	連
链	鍊
链	鏈
鲢	鰱
锊	鋝
奁	奩
帘	簾
敛	斂
殓	殮
潋	瀲
莶	薟
蔹	蘞
镰	鐮
猎	獵
岭	嶺
棂	欞
棂	櫺
灵	靈
铃	鈴
领	領
龄	齡
隶	隸
礼	禮
鳢	鱧
劳	勞
卢	盧
卤	鹵
卤	滷
唠	嘮
噜	嚕
垆	壚
芦	蘆
崂	嶗
捞	撈
掳	擄
撸	擼
栌	櫨
橹	櫓
橹	艣
氇	氌
泸	瀘
涝	澇
炉	爐
痨	癆
舻	艫
虏	虜
轳	轤
辂	輅
铑	銠
铹	鐒
颅	顱
鲁	魯
鲈	鱸
鸬	鸕
鹭	鷺
录	錄
渌	淥
禄	祿
绿	綠
辘	轆
论	論
咙	嚨
垄	壟
拢	攏
栊	櫳
泷	瀧
珑	瓏
砻	礱
笼	籠
聋	聾
胧	朧
茏	蘢
陇	隴
濑	瀨
籁	籟
诔	誄
赂	賂
赉	賚
赖	賴
镭	鐳
了	暸
了	瞭
疗	療
缭	繚
辽	遼
镣	鐐
闹	鬧
鹩	鷯
胧	矓
龙	龍
偻	僂
喽	嘍
垒	壘
娄	婁
屡	屢
嵝	嶁
搂	摟
楼	樓
泪	淚
瘘	瘺
篓	簍
缕	縷
耧	耬
蒌	蔞
蝼	螻
褛	褸
镂	鏤
髅	髏
累	纍
溜	霤
刘	劉
浏	瀏
类	類
绺	綹
缧	縲
谬	謬
铆	鉚
镏	鎦
馏	餾
骝	騮
鹨	鷚
戮	僇
陆	陸
仑	侖
仑	崙
伦	倫
囵	圇
抡	掄
沦	淪
纶	綸
轮	輪
栗	慄
仂	扐
鳓	鰳
凛	凜
廪	廩
檩	懍
檩	檁
菱	蔆
棱	稜
绫	綾
鲮	鯪
厘	釐
离	離
狸	貍
里	裡
里	裏
里	浬
漓	灕
犁	犛
莅	蒞
篱	籬
缡	縭
蓠	蘺
逦	邐
锂	鋰
鲤	鯉
鹂	鸝
磷	燐
蔺	藺
躏	躪
辚	轔
邻	鄰
鳞	鱗
麻	痳
临	臨
麻	痲
麽	麼
么	麽
吗	嗎
唛	嘜
妈	媽
嬷	嬤
杩	榪
玛	瑪
码	碼
蚂	螞
马	馬
镆	鏌
馍	饃
挽	輓
万	萬
峦	巒
弯	彎
懑	懣
湾	灣
满	滿
瞒	瞞
缦	縵
蛮	蠻
谩	謾
镘	鏝
颟	顢
馒	饅
鳗	鰻
袜	襪
网	網
辋	輞
买	買
劢	勱
卖	賣
迈	邁
骂	罵
脉	脈
蓦	驀
麦	麥
锰	錳
幂	冪
觅	覓
面	麵
绵	綿
缅	緬
蔑	衊
灭	滅
铭	銘
鸣	鳴
谋	謀
谟	謨
馍	糢
钼	鉬
鹜	鶩
殁	歿
没	沒
蒙	濛
蒙	懞
蒙	矇
梦	夢
猫	貓
庙	廟
缈	緲
锚	錨
无	無
亩	畝
务	務
呒	嘸
妩	嫵
庑	廡
怃	憮
抚	撫
缪	繆
芜	蕪
诬	誣
贸	貿
雾	霧
骛	騖
鹉	鵡
们	們
擦	抆
扪	捫
纹	紋
钔	鍆
门	門
问	問
闻	聞
阌	閿
霉	黴
弥	彌
弥	瀰
猕	獼
眯	瞇
芈	羋
谜	謎
镁	鎂
悯	憫
渑	澠
焖	燜
缗	緡
闵	閔
闷	悶
闽	閩
黾	黽
谧	謐
朴	樸
扑	撲
剥	剝
缚	縛
钋	釙
铂	鉑
镤	鏷
飑	颮
驳	駁
板	闆
盘	盤
盘	槃
矾	礬
绊	絆
蹒	蹣
颁	頒
饭	飯
发	發
发	髮
拨	撥
泼	潑
钵	缽
钹	鈸
饽	餑
鹁	鵓
碰	踫
仿	倣
旁	徬
帮	幫
庞	龐
纺	紡
绑	綁
访	訪
谤	謗
钫	鈁
镑	鎊
鲂	魴
背	揹
赔	賠
辈	輩
烦	煩
罚	罰
阀	閥
泛	氾
泛	汎
范	範
钒	釩
珐	琺
蘖	蘗
辟	闢
变	變
拚	抃
笾	籩
辩	辯
辫	辮
边	邊
别	別
别	彆
瘪	癟
鳖	鱉
并	並
并	併
饼	餅
骈	駢
宝	寶
报	報
补	補
谱	譜
辅	輔
镨	鐠
鸨	鴇
卜	蔔
仆	僕
复	複
辐	輻
鳆	鰒
凤	鳳
缝	縫
锋	鋒
夫	伕
凫	鳧
复	復
妇	婦
肤	膚
讣	訃
负	負
赋	賦
赙	賻
驸	駙
鲋	鮒
麸	麩
偾	僨
喷	噴
坟	墳
奋	奮
愤	憤
粪	糞
纷	紛
贲	賁
锛	錛
佛	彿
绂	紱
绋	紼
绷	繃
鹏	鵬
秘	祕
痹	痺
扉	屝
备	備
惫	憊
痱	疿
箅	箄
纰	紕
绯	緋
罴	羆
诽	誹
费	費
辔	轡
镄	鐨
飞	飛
鲱	鯡
傧	儐
苹	蘋
嫔	嬪
宾	賓
摈	擯
槟	檳
殡	殯
滨	濱
濒	瀕
缤	繽
膑	臏
贫	貧
镔	鑌
频	頻
颦	顰
髌	髕
鬓	鬢
凭	憑
骋	騁
舍	捨
蓑	簑
丝	絲
写	寫
厍	厙
隳	皻
师	師
泻	瀉
狮	獅
筛	篩
纱	紗
蛳	螄
诈	詐
词	詞
谢	謝
赊	賒
赐	賜
辞	辭
铊	鉈
饲	飼
驶	駛
驷	駟
鲨	鯊
鸶	鷥
烁	爍
铄	鑠
酸	痠
产	產
伞	傘
删	刪
姗	姍
讪	訕
铲	剷
铲	鏟
闩	閂
杀	殺
萨	薩
渗	滲
毵	毿
糁	糝
钐	釤
涩	澀
锸	鍤
飒	颯
丧	喪
伤	傷
偿	償
厢	廂
尝	嘗
殇	殤
状	狀
缃	緗
觞	觴
详	詳
赏	賞
颡	顙
玺	璽
赛	賽
鳃	鰓
啬	嗇
穑	穡
赜	賾
铯	銫
栖	棲
书	書
叙	敘
屿	嶼
纾	紓
绪	緒
锄	鋤
泻	潟
硕	碩
释	釋
锡	錫
亘	亙
旋	鏇
婵	嬋
猕	獮
癣	癬
禅	禪
籼	秈
线	線
缮	繕
羡	羨
藓	蘚
蝉	蟬
诜	詵
跹	躚
选	選
铣	銑
镟	鏇
骟	騸
鲜	鮮
鳝	鱔
泄	洩
曳	抴
亵	褻
啮	齧
绁	紲
设	設
说	說
鳕	鱈
掺	摻
歼	殲
窍	纖
纤	纖
谵	譫
赡	贍
闪	閃
陕	陝
嗫	囁
慑	懾
摄	攝
滠	灄
聂	聶
蹑	躡
镊	鑷
颞	顳
圣	聖
声	聲
诚	誠
铖	鋮
势	勢
岁	歲
税	稅
细	細
贳	貰
筱	篠
啸	嘯
扫	掃
潇	瀟
烧	燒
稣	穌
箫	簫
绍	紹
缫	繅
苏	甦
苏	蘇
苏	囌
萧	蕭
诉	訴
销	銷
骚	騷
属	屬
续	續
谡	謖
赎	贖
孙	孫
损	損
狲	猻
荪	蓀
逊	遜
松	鬆
讼	訟
诵	誦
锶	鍶
颂	頌
洒	灑
唢	嗩
晒	曬
琐	瑣
铩	鎩
锁	鎖
钊	釗
修	脩
兽	獸
寿	壽
帅	帥
擞	擻
数	數
树	樹
竖	豎
绣	繡
绥	綏
绶	綬
薮	藪
虽	雖
谁	誰
谇	誶
输	輸
铢	銖
锈	銹
锈	鏽
锼	鎪
随	隨
雠	讎
须	須
须	鬚
飕	颼
馊	餿
馐	饈
肃	肅
唇	脣
笋	筍
纯	純
询	詢
谆	諄
顺	順
驯	馴
鹑	鶉
恤	卹
术	術
习	習
湿	濕
湿	溼
袭	襲
绳	繩
胜	勝
蝇	蠅
厮	廝
弑	弒
埘	塒
时	時
缌	緦
莳	蒔
视	視
试	試
诗	詩
酾	釃
铈	鈰
鲥	鰣
蚀	蝕
识	識
轼	軾
饰	飾
烬	燼
绅	紳
肾	腎
荩	藎
讯	訊
赆	贐
实	實
沈	瀋
婶	嬸
审	審
寻	尋
浔	潯
渖	瀋
谂	諗
谌	諶
镡	鐔
鲟	鱘
双	雙
亚	亞
儿	兒
哑	啞
娅	婭
桠	椏
氩	氬
讶	訝
钶	鈳
锕	錒
饿	餓
鸦	鴉
鹅	鵝
岳	嶽
乐	樂
垩	堊
恶	惡
谔	諤
锷	鍔
颚	顎
鳄	鱷
鹗	鶚
龌	齷
赝	贗
铵	銨
顸	頇
颜	顏
讦	訐
谒	謁
轧	軋
阏	閼
岩	巖
庵	菴
岩	嵒
谙	諳
鹌	鵪
压	壓
鸭	鴨
鸯	鴦
碍	礙
嗳	噯
嫒	嬡
暧	曖
爱	愛
瑷	璦
皑	皚
蔼	藹
阂	閡
霭	靄
厄	阨
缢	縊
轭	軛
额	額
嘤	嚶
樱	櫻
罂	罌
莺	鶯
鹦	鸚
爷	爺
龠	籥
哟	喲
约	約
药	葯
药	藥
跃	躍
钥	鑰
娘	孃
痒	癢
养	養
扬	颺
扬	揚
杨	楊
样	樣
炀	煬
疡	瘍
让	讓
酿	釀
镶	鑲
镶	瓖
阳	陽
阳	暘
骧	驤
御	禦
渔	漁
语	語
饫	飫
驭	馭
鱼	魚
龉	齬
亿	億
忆	憶
鼹	鼴
彦	彥
瘪	牪
谚	諺
谳	讞
镍	鎳
陧	隉
严	嚴
俨	儼
腌	醃
酽	釅
阉	閹
业	業
邺	鄴
余	餘
与	與
欤	歟
畲	畬
舆	輿
蓣	蕷
铷	銣
睾	睪
峄	嶧
怿	懌
绎	繹
译	譯
阈	閾
驿	驛
演	縯
烟	煙
咽	嚥
兖	兗
橼	櫞
渊	淵
砚	硯
缘	緣
软	軟
铅	鉛
鸢	鳶
悦	悅
热	熱
阅	閱
焰	燄
厌	厭
厣	厴
恹	懨
盐	鹽
艳	艷
艳	豔
闫	閆
阎	閻
餍	饜
魇	魘
鲶	鯰
叶	葉
晔	曄
烨	燁
靥	靨
咏	詠
婴	嬰
嵘	嶸
撄	攖
狞	獰
璎	瓔
瘿	癭
缨	纓
茔	塋
荣	榮
营	營
萦	縈
蝾	蠑
赢	贏
颍	潁
颖	穎
呓	囈
瘗	瘞
秽	穢
艺	藝
誉	譽
诣	詣
锐	銳
预	預
鲵	鯢
圬	杇
乌	烏
吴	吳
呜	嗚
坞	塢
垭	埡
奥	奧
娱	娛
恶	噁
污	汙
袄	襖
误	誤
邬	鄔
钨	鎢
骜	驁
鳌	鰲
鳌	鼇
狱	獄
钰	鈺
媪	媼
愠	慍
氲	氳
温	溫
稳	穩
蕴	蘊
酝	醞
酝	醖
韫	韞
腽	膃
瓮	甕
拥	擁
痈	癰
痈	廱
洼	窪
卧	臥
栀	枙
涡	渦
窝	窩
莴	萵
蜗	蝸
讹	訛
缓	緩
顽	頑
娲	媧
聩	聵
侥	僥
祆	祅
娆	嬈
尧	堯
扰	擾
挠	撓
摇	搖
桡	橈
浇	澆
瑶	瑤
窑	窯
绕	繞
荛	蕘
蛲	蟯
谣	謠
遥	遙
铫	銚
饶	饒
鳐	鰩
鹞	鷂
缛	縟
鹆	鵒
熔	鎔
踊	踴
涌	湧
佣	傭
耸	聳
镛	鏞
俣	俁
佑	祐
优	優
忧	憂
怄	慪
纡	紆
邮	郵
鱿	魷
龋	齲
勖	勗
顼	頊
云	雲
韵	韻
芸	蕓
恽	惲
殒	殞
殒	抎
纭	紜
运	運
郓	鄆
郧	鄖
陨	隕
郁	鬱
愿	願
员	員
园	園
圆	圓
诨	諢
辕	轅
远	遠
鸳	鴛
鼋	黿
粤	粵
钺	鉞
钺	戉
为	為
伟	偉
伪	偽
卫	衛
喂	餵
围	圍
帏	幃
沩	溈
涠	潿
炜	煒
玮	瑋
纬	緯
苇	葦
诿	諉
谓	謂
违	違
闱	闈
韦	韋
韪	韙
吁	籲
游	遊
嵛	崳
潍	濰
犹	猶
维	維
莸	蕕
觎	覦
诱	誘
谀	諛
谕	諭
遗	遺
铀	鈾
铕	銪
鲔	鮪
润	潤
闰	閏
绒	絨
殷	慇
瘾	癮
银	銀
隐	隱
钇	釔
荫	蔭
阴	陰
饮	飲
应	應
鹰	鷹
义	義
仪	儀
医	醫
拟	擬
舣	艤
蚁	蟻
议	議
谊	誼
铱	銥
镱	鐿
尔	爾
迤	迆
异	異
诒	詒
贰	貳
贻	貽
迩	邇
铒	鉺
颐	頤
饴	飴
饵	餌
鲕	鮞
鸸	鴯
谥	謚
纫	紉
认	認
轫	軔
铟	銦
韧	韌
镒	鎰
赁	賃
饪	飪
眦	眥
借	藉
兹	茲
兹	玆
谘	諮
赀	貲
资	資
锌	鋅
鹚	鶿
鹧	鷓
绰	綽
鹊	鵲
栈	棧
残	殘
盏	盞
骣	驏
潜	潛
蚕	蠶
暂	暫
赚	賺
杂	雜
装	裝
庄	莊
场	場
墙	墻
墙	牆
壮	壯
奖	奬
奖	獎
妆	妝
嫱	嬙
将	將
帐	帳
张	張
桨	槳
桩	樁
樯	檣
浆	漿
肠	腸
脏	臟
脏	髒
苌	萇
蒋	蔣
蔷	薔
账	賬
赃	贓
赃	贜
酱	醬
锵	鏘
长	長
驵	駔
才	纔
灾	災
斋	齋
财	財
载	載
龇	齜
争	爭
峥	崢
挣	掙
枪	鎗
狰	猙
筝	箏
诤	諍
铮	錚
薯	藷
抵	牴
猪	豬
伫	佇
储	儲
着	著
槠	櫧
苎	苧
诅	詛
诋	詆
贮	貯
这	這
龃	齟
适	適
迹	跡
墒	墑
敌	敵
碛	磧
积	勣
积	積
籴	糴
绩	績
觌	覿
谪	謫
贼	賊
镝	鏑
淀	澱
专	專
传	傳
啭	囀
巅	巔
戋	戔
战	戰
戬	戩
毡	氈
电	電
癫	癲
砖	磚
笺	箋
缚	縳
缠	纏
腼	靦
诠	詮
转	轉
辁	輇
辗	輾
钱	錢
钿	鈿
铣	鐉
铨	銓
镌	鐫
阗	闐
颛	顓
颠	顛
颤	顫
饯	餞
窃	竊
疖	癤
绝	絕
节	節
念	唸
占	佔
点	點
沾	霑
垫	墊
渐	漸
折	摺
鲽	鰈
侦	偵
净	淨
净	凈
帧	幀
枨	棖
柽	檉
桢	楨
浈	湞
睁	睜
祯	禎
蛏	蟶
订	訂
贞	貞
郑	鄭
钉	釘
钲	鉦
铤	鋌
锭	錠
靓	靚
静	靜
顶	頂
堤	隄
制	製
侪	儕
剂	劑
哜	嚌
挤	擠
济	濟
绨	綈
缇	緹
脐	臍
荠	薺
蛴	蠐
诸	諸
跻	躋
锑	銻
际	際
霁	霽
题	題
鲚	鱭
鹈	鵜
齐	齊
齑	齏
吊	弔
雕	彫
噪	譟
条	條
枣	棗
灶	竈
粜	糶
组	組
绦	絛
缲	繰
茑	蔦
诏	詔
调	調
赵	趙
钌	釕
钓	釣
鲦	鰷
鲷	鯛
鸟	鳥
镞	鏃
踪	蹤
从	從
怂	慫
枞	樅
种	種
纵	縱
终	終
综	綜
肿	腫
钟	鐘
锺	鍾
锉	銼
周	週
注	註
朱	硃
胄	冑
丢	丟
俦	儔
凑	湊
厨	廚
帱	幬
昼	晝
橱	櫥
畴	疇
筹	籌
纣	紂
绸	綢
诛	誅
踌	躊
蹰	躕
辏	輳
铥	銩
铸	鑄
驻	駐
准	準
隽	雋
骏	駿
鳟	鱒
众	眾
众	衆
鲫	鯽
栉	櫛
骘	騭
缯	繒
证	証
证	證
赠	贈
抵	扺
志	誌
址	阯
冲	遲
挚	摯
渍	漬
纸	紙
贽	贄
踬	躓
轵	軹
轾	輊
迟	遲
鸷	鷙
织	織
职	職
晋	晉
尘	塵
尽	盡
尽	儘
缙	縉
缜	縝
诊	診
赈	賑
轸	軫
进	進
镇	鎮
阵	陣
陈	陳
侄	姪
质	質
轶	軼
鸩	鴆
执	執
絷	縶
缉	緝
辑	輯
征	徵
症	癥
惩	懲
叉	扠
砗	硨
车	車
鹾	鹺
凿	鑿
诼	諑
错	錯
龊	齪
漓	巑
撺	攛
攒	攢
灿	燦
瓒	瓚
窜	竄
缵	纘
赞	讚
赞	贊
趱	趲
蹿	躥
躜	躦
钻	鑽
馔	饌
刹	剎
咱	偺
铡	鍘
参	參
堑	塹
崭	嶄
忏	懺
惨	慘
惭	慚
搀	攙
斩	斬
椠	槧
碜	磣
谗	讒
谮	譖
谶	讖
錾	鏨
馋	饞
骖	驂
黪	黲
仓	倉
伥	倀
伧	傖
创	創
厂	廠
呛	嗆
怅	悵
怆	愴
戗	戧
抢	搶
枪	槍
沧	滄
涨	漲
炝	熗
畅	暢
疮	瘡
胀	脹
舱	艙
苍	蒼
跄	蹌
锖	錆
阊	閶
鲳	鯧
债	債
彩	綵
采	採
虿	蠆
钗	釵
册	冊
啧	嘖
帻	幘
栅	柵
箦	簀
责	責
凄	悽
凄	淒
处	處
觑	覷
只	隻
跖	蹠
尺	呎
戚	慼
出	齣
掷	擲
涤	滌
踯	躑
千	韆
荐	薦
冁	囅
浅	淺
溅	濺
蒇	蕆
贱	賤
践	踐
迁	遷
钏	釧
阐	闡
鞯	韉
彻	徹
缀	綴
辍	輟
辙	轍
铁	鐵
锇	鋨
佥	僉
檐	簷
签	簽
签	籤
裣	襝
觇	覘
谄	諂
叠	疊
谍	諜
贴	貼
辄	輒
钻	鉆
听	聽
厅	廳
请	請
鲭	鯖
体	體
屉	屜
滞	滯
缔	締
谛	諦
递	遞
剿	勦
迢	岧
础	礎
绡	綃
艹	艸
诌	謅
诮	誚
谯	譙
轺	軺
钞	鈔
锹	鍬
鹪	鷦
龆	齠
嘱	囑
烛	燭
瞩	矚
触	觸
寸	吋
丛	叢
偬	傯
葱	蔥
宠	寵
总	總
聪	聰
苁	蓯
铳	銃
骢	驄
睃	脧
刍	芻
秋	鞦
丑	醜
坠	墜
枢	樞
皱	皺
绉	縐
缒	縋
诹	諏
趋	趨
邹	鄒
锤	錘
锥	錐
雏	雛
驺	騶
骓	騅
鲰	鯫
鳅	鰍
筑	築
缩	縮
轴	軸
术	朮
绌	絀
冲	沖
冲	衝
虫	蟲
赘	贅
骤	驟
鹫	鷲
侧	側
仄	庂
厕	廁
恻	惻
测	測
榇	櫬
龀	齔
层	層
致	緻
痴	癡
帜	幟
栀	梔
炽	熾
缁	緇
耻	恥
觯	觶
辎	輜
锱	錙
驰	馳
鲻	鯔
鸱	鴟
齿	齒
则	則
饬	飭
亲	親
衬	襯
寝	寢
针	針
锓	鋟
蛰	蟄
称	稱
侩	儈
哙	噲
堕	墮
椭	橢
缍	綞
诧	詫
锗	鍺
驮	馱
驼	駝
鸵	鴕
鼍	鼉
托	託
浊	濁
箨	籜
铎	鐸
镯	鐲
叹	歎
叹	嘆
弹	彈
惮	憚
掸	撣
摊	攤
殚	殫
滩	灘
痪	瘓
瘫	癱
绽	綻
诞	誕
夺	奪
脱	脫
掸	撢
贪	貪
赕	賧
鳎	鰨
汤	湯
烫	燙
砀	碭
荡	蕩
荡	盪
铴	鐋
兑	兌
台	颱
态	態
绐	紿
蜕	蛻
钛	鈦
骀	駘
鲐	鮐
择	擇
泽	澤
撑	撐
摅	攄
讨	討
钍	釷
吨	噸
恸	慟
统	統
颓	頹
囱	囪
铽	鋱
闯	闖
摆	擺
罢	罷
钯	鈀
颇	頗
办	辦
贩	販
钣	鈑
呗	唄
坝	壩
佩	珮
狈	狽
贝	貝
败	敗
钡	鋇
缏	緶
编	編
谝	諞
骗	騙
贬	貶
评	評
币	幣
废	廢
毙	斃
闭	閉
刨	鉋
刨	鑤
炮	砲
布	佈
抛	拋
疱	皰
钸	鈽
铺	鋪
饱	飽
鲍	鮑
龅	齙
表	錶
标	標
缥	縹
镖	鏢
镳	鑣
飘	飄
飙	飆
骠	驃
鳔	鰾
禀	稟
丰	豐
冯	馮
枫	楓
沣	灃
疯	瘋
讽	諷
风	風
摆	襬
铍	鈹
哔	嗶
毕	畢
滗	潷
笔	筆
筚	篳
荜	蓽
跸	蹕
铋	鉍
鹎	鵯
厦	廈
苄	芐
虾	蝦
贺	賀
学	學
泶	澩
疟	瘧
谑	謔
鹤	鶴
娴	嫻
扞	捍
汉	漢
焊	銲
钎	釬
闲	閑
闲	閒
韩	韓
鹇	鷳
鹇	鷴
辖	轄
咸	鹹
槛	檻
缄	緘
舰	艦
衔	啣
衔	銜
颔	頷
馅	餡
合	郃
合	閤
阖	闔
陕	陜
颌	頜
鸽	鴿
肮	骯
钪	鈧
闶	閌
项	項
颃	頏
该	該
谐	諧
赅	賅
颏	頦
骇	駭
鲑	鮭
核	覈
幸	倖
绗	絎
乡	鄉
响	響
向	嚮
芗	薌
飨	饗
饷	餉
嘘	噓
虚	虛
许	許
宪	憲
擀	搟
献	獻
轩	軒
猃	獫
险	險
验	驗
吓	嚇
阋	鬩
县	縣
弦	絃
岘	峴
悬	懸
显	顯
现	現
绚	絢
苋	莧
蚬	蜆
贤	賢
铉	鉉
页	頁
侠	俠
协	協
夹	夾
峡	峽
惬	愜
挟	挾
浃	浹
狭	狹
硖	硤
箧	篋
胁	脅
荚	莢
蛱	蛺
铗	鋏
铪	鉿
颊	頰
滢	瀅
潆	瀠
荆	荊
荥	滎
荧	熒
莹	瑩
萤	螢
蓥	鎣
陉	陘
号	號
壶	壺
胡	鬍
户	戶
护	護
沪	滬
浒	滸
灏	灝
缟	縞
蚝	蠔
镐	鎬
颢	顥
鹕	鶘
浑	渾
珲	琿
阍	閽
馄	餛
哄	鬨
红	紅
荭	葒
讧	訌
鸿	鴻
华	華
哗	嘩
桦	樺
画	畫
祸	禍
话	話
货	貨
钬	鈥
铧	鏵
骅	驊
确	確
扩	擴
获	穫
镬	鑊
唤	喚
奂	奐
丸	汍
换	換
欢	歡
涣	渙
焕	煥
环	環
纨	紈
缳	繯
还	還
锾	鍰
鲩	鯇
鳏	鰥
阔	闊
况	況
谎	謊
贶	貺
鳇	鰉
黄	黃
哕	噦
会	會
刽	劊
回	迴
徊	佪
怀	懷
桧	檜
汇	匯
浍	澮
烩	燴
狯	獪
绘	繪
脍	膾
荟	薈
诙	詼
诲	誨
贿	賄
郐	鄶
划	劃
获	獲
横	橫
黉	黌
哓	嘵
嚣	囂
肴	餚
晓	曉
枭	梟
骁	驍
后	後
诟	詬
诩	詡
鲎	鱟
勋	勛
埙	塤
埙	壎
晕	暈
荤	葷
训	訓
谖	諼
毁	燬
毁	毀
挥	揮
晖	暉
汇	彙
讳	諱
辉	輝
亏	虧
携	攜
鸺	鵂
谲	譎
鹬	鷸
凶	兇
汹	洶
欣	訢
衅	釁
扦	扢
纥	紇
讫	訖
揿	撳
钦	欽
兴	興
曦	晞
戏	戲
牺	犧
诶	誒
饩	餼
撷	擷
缬	纈
诘	詰
颉	頡
