卻	却
強	强
啟	啓
礦	鑛
亙	亘
涼	凉
隸	隷
鄰	隣
晚	晩
貓	猫
幫	幇
仿	倣
翻	飜
祕	秘
冰	氷
產	産
滲	渗
澀	澁
插	揷
溯	遡
讎	讐
礙	碍
汙	汚
姊	姉
妝	粧
獎	奬
絕	絶
黏	粘
蹤	踪
眾	衆
窗	窓
剎	刹
敕	勅
橢	楕
朵	朶
吞	呑
撐	撑
兔	兎
鬥	鬪
霸	覇
拋	抛
豐	豊
迥	逈
畫	畵
迴	廻
勛	勳
毀	毁
攜	携
戲	戱
舉	擧
开	幵
雞	鷄
教	敎
既	旣
抬	擡
郎	郞
裡	裏
查	査
尚	尙
緒	緖
敘	敍
婿	壻
晰	晳
鏽	銹
柿	枾
為	爲
俞	兪
飲	飮
真	眞
咒	呪
慚	慙
甜	甛
青	靑
匆	悤
值	値